13,13,9

0,89,1,1,1,1,1,1,1
0,49,1,1,1,1,1,1,1
0,49,1,1,1,1,1,1,1
0,49,1,1,1,1,1,1,1
0,49,1,1,1,1,1,1,1
0,49,1,1,1,1,1,1,1
0,49,1,1,1,1,1,1,1
0,49,1,1,1,1,1,1,1
0,49,1,1,1,1,1,1,1
0,49,1,1,1,1,1,1,1
0,1,1,1,1,1,1,1,1
0,0,0,0,0,0,0,0,0
0,0,0,0,0,0,0,0,0

0,0,1,1,1,1,1,1,1
0,0,1,9,9,9,9,9,1
0,0,1,9,9,9,9,9,1
0,0,1,9,9,9,9,9,1
0,0,1,9,9,9,9,9,1
0,0,1,9,9,9,9,9,1
0,0,1,9,9,9,9,9,1
0,0,1,9,9,9,9,9,1
0,0,1,9,9,9,9,9,1
0,0,49,9,9,9,9,9,1
0,1,1,1,1,1,1,1,1
0,0,0,0,0,0,0,0,0
0,0,0,0,0,0,0,0,0

0,0,1,1,1,1,1,1,1
0,0,0,0,0,0,0,0,1
0,0,0,0,0,0,0,0,1
0,0,0,0,0,0,0,0,1
0,0,0,0,0,0,0,0,1
0,0,0,0,0,0,0,0,1
0,0,0,0,0,0,0,0,1
0,0,89,0,0,0,0,0,1
0,0,49,0,0,0,0,0,1
0,0,0,0,0,0,0,0,1
0,1,1,1,1,1,1,1,1
0,0,0,0,0,0,0,0,0
0,0,0,0,0,0,0,0,0

0,0,1,1,1,1,1,1,1
0,0,49,49,0,0,0,0,1
0,0,49,0,0,0,0,0,1
0,0,49,0,0,0,0,0,1
0,0,49,0,0,0,0,0,1
0,0,49,0,0,0,0,0,1
0,0,49,0,0,0,0,0,1
0,0,49,0,0,0,0,0,1
0,0,0,0,0,0,0,0,1
0,0,0,0,0,0,0,0,1
0,1,1,1,1,1,1,1,1
0,0,0,0,0,0,0,0,0
0,0,0,0,0,0,0,0,0

0,0,1,1,1,1,1,1,1
0,0,0,0,0,0,0,0,1
0,0,0,49,0,0,0,0,1
0,0,0,89,0,0,0,0,1
0,0,0,0,0,0,0,0,1
0,0,0,0,0,0,0,0,1
0,0,0,0,0,0,0,0,1
0,0,0,0,0,0,0,0,1
0,0,0,0,0,0,0,0,1
0,0,0,0,0,0,0,0,1
0,1,1,1,1,1,1,1,1
0,0,0,0,0,0,0,0,0
0,0,0,0,0,0,0,0,0

0,0,1,1,1,1,1,1,1
0,0,0,0,0,0,0,0,1
0,0,0,0,0,0,0,0,1
0,0,0,49,0,0,0,0,1
0,0,0,49,0,0,0,0,1
0,0,0,49,0,0,0,0,1
0,0,0,49,0,0,0,0,1
0,0,0,49,0,0,0,0,1
0,0,0,49,49,0,0,0,1
0,0,0,49,49,0,0,0,1
0,1,1,1,1,1,1,1,1
0,0,0,0,0,0,0,0,0
0,0,0,0,0,0,0,0,0

0,0,1,1,1,1,1,1,1
0,0,0,0,0,0,0,0,1
0,0,0,0,0,0,0,0,1
0,0,0,0,0,0,0,0,1
0,0,0,0,0,0,0,0,1
0,0,0,0,0,0,0,0,1
0,0,0,0,0,0,0,0,1
0,0,0,0,89,0,0,0,1
0,0,0,0,49,0,0,0,1
0,0,0,0,0,0,0,0,1
0,1,1,1,1,1,1,1,1
0,0,0,0,0,0,0,0,0
0,0,0,0,0,0,0,0,0

0,0,1,1,1,1,1,1,1
0,0,0,0,49,49,0,0,1
0,0,0,0,49,0,0,0,1
0,0,0,0,49,0,0,0,1
0,0,0,0,49,0,0,0,1
0,0,0,0,49,0,0,0,1
0,0,0,0,49,0,0,0,1
0,0,0,0,49,0,0,0,1
0,0,0,0,0,0,0,0,1
0,0,0,0,0,0,0,0,1
0,1,1,1,1,1,1,1,1
0,0,0,0,0,0,0,0,0
0,0,0,0,0,0,0,0,0

0,0,1,1,1,1,1,1,1
0,0,0,0,0,0,0,0,1
0,0,0,0,0,49,0,0,1
0,0,0,0,0,89,0,0,1
0,0,0,0,0,0,0,0,1
0,0,0,0,0,0,0,0,1
0,0,0,0,0,0,0,0,1
0,0,0,0,0,0,0,0,1
0,0,0,0,0,0,0,0,1
0,0,0,0,0,0,0,0,1
0,1,1,1,1,1,1,1,1
0,0,0,0,0,0,0,0,0
0,0,0,0,0,0,0,0,0

0,0,1,1,1,1,1,1,1
0,0,0,0,0,0,0,0,1
0,0,0,0,0,0,0,0,1
0,0,0,0,0,49,0,0,1
0,0,0,0,0,49,0,0,1
0,0,0,0,0,49,0,0,1
0,0,0,0,0,49,0,0,1
0,0,0,0,0,49,0,0,1
0,0,0,0,0,49,89,89,1
0,0,0,0,0,49,89,89,1
0,1,1,1,1,1,1,1,1
0,0,0,0,0,0,0,0,0
0,0,0,0,0,0,0,0,0

0,0,0,0,0,0,0,0,0
0,0,0,0,0,0,0,0,0
0,0,0,0,0,0,0,0,0
0,0,0,0,0,0,0,0,0
0,0,0,0,0,0,0,0,0
0,0,0,0,0,0,0,0,0
0,0,0,0,0,0,0,0,0
0,0,0,0,0,0,0,0,0
0,0,0,0,0,0,0,0,0
0,0,0,0,0,0,0,57,0
0,0,0,0,0,0,0,0,0
0,0,0,0,0,0,0,0,0
0,0,0,0,0,0,0,0,0

0,0,0,0,0,0,0,0,0
0,0,0,0,0,0,0,0,0
0,0,0,0,0,0,0,0,0
0,0,0,0,0,0,0,0,0
0,0,0,0,0,0,0,0,0
0,0,0,0,0,0,0,0,0
0,0,0,0,0,0,0,0,0
0,0,0,0,0,0,0,0,0
0,0,0,0,0,0,0,0,0
0,0,0,0,0,0,0,0,0
0,0,0,0,0,0,0,0,0
0,0,0,0,0,0,0,0,0
0,0,0,0,0,0,0,0,0

0,0,0,0,0,0,0,0,0
0,0,0,0,0,0,0,0,0
0,0,0,0,0,0,0,0,0
0,0,0,0,0,0,0,0,0
0,0,0,0,0,0,0,0,0
0,0,0,0,0,0,0,0,0
0,0,0,0,0,0,0,0,0
0,0,0,0,0,0,0,0,0
0,0,0,0,0,0,0,0,0
0,0,0,0,0,0,0,0,0
0,0,0,0,0,0,0,0,0
0,0,0,0,0,0,0,0,0
0,0,0,0,0,0,0,0,0
